1 13 31
###############################
#      ** *    *   *  * * *   #
# # # #*# # #*#*# # # #*#*#*# #
#p  *     ***  *      *   * * #
# # # # # #*# # #*#*# # # # #*#
#f           **  *  *         #
# # # # # # # # # #*# #*# # # #
#*  *      *  *      *        #
# # # # #*# # # #*#*# # # # # #
#*    **  *       *           #
# #*# # # # # # #*# # # # # # #
#           *   *  *        x #
###############################