3 13 31
###############################
#  1   ** *    *   *  *   *  5#
# # # #*# # #*#*# # #*# # #*# #
#p         1   *  6   * 2   * #
#6#*#6# # #*# # #*#*# # #6# #*#
#        3   **  *  *         #
# # # # # # # # # #*# #*#6# # #
#*  *      *  *      *   3    #
# # # # #*# # # #*#*# # #6# # #
#3    **  *    6  *           #
# #*# # # # # # #*# # # # # ###
#2          *   *  *        #4#
###############################