1 13 31
###############################
#      ** *    *   *  * * *   #
# # # #*# # #*#*# # # #*#*#*# #
#p x*     ***  *      *   * * #
# # # # # #*# # #*#*# # # # #*#
#f   4       **  *  *         #
# # # # # # # # # #*# #*# # # #
#*  *      *  *  3   *        #
# # # # #*# # # #*#*# # # # # #
#*    **  *       *           #
# #*# # # # # # #*# # # # # # #
#           *   *  *        x #
###############################