1 13 31
###############################
#1     ** *    *   *  * * *   #
# # # #6# # #*#*# # # #*#*#*# #
#p x*     *6*  *      *   * * #
# # # # # #*# # #*#*# # # # #*#
#f           *6  *  *     5   #
# # # # # # # # # #*# #*# # # #
#*  *      *  *  3   *        #
# # # # #*# # # #*#*# # # # # #
#*    **  *       6          4#
# #6# # # # # # #*# # # # # # #
#2          *   *  *        x #
###############################