2 13 31
###############################
#  1 6    6    *   *  *   *  2#
# # # #*# # #*#*# # #*# # #*# #
#p        ***  *      * 2   * #
# # # # # #*# # #*#*# # # # #*#
#        3   **  *  *         #
# # # # # # # # # #*# #*# # # #
#*  *      *  *      *   3    #
# # # # #*# # # #*#*# # # # # #
#*    **  *       *           #
# #*# # # # # # #*# # # # # ###
#   1 6     *   *  *        #4#
###############################