1 13 31
###############################
#      ** *    *   *  * * *   #
# # # #6# # #*#*# # # #*#*#*# #
#p x*     *6*  *      *   * * #
# # # # # #*# # #*#*# # # # #*#
#f           *6  *  *         #
# # # # # # # # # #*# #*# # # #
#*  *      *  *  3   *        #
# # # # #*# # # #*#*# # # # # #
#*    **  *       6           #
# #6# # # # # # #*# # # # # # #
#           *   *  *        x #
###############################